00000000000000000000-
00000000000000000000-
00000000000000000000-
11111111000000000000-
00000000000000000000-
000000000000000x0000-
00000000011111111100-
00000000000000000000-
000x000x000000000000-
11111111111000000011-
00000000000000000000-
00000000000000000000-
11111100000111111111-
00000000000000000000-
0000000p000000000000
